11111111111111111111111111111111111111111111111111111111111111111111
100000000000000001100000000000000000000000000000000001100000000000001
100000000000000001100000000000000000000000000000000001100000000001111
100000000000000001100000000000000000000000000000000001100000000001111111
100000000000000000000000000000000000000000000000000001100000000000000001
100000000000000000000000000000000000000000000000000000000000000000000001
100000000000000001100000000000000000001000000000000000000000000000000001
100000000000000001100000000000000000000100000000000000000000000000000001111111
10000000000000000110000000000000000000001000000000000000000000000000000000001
1000000000000000011000000000000000000000000000000000000000000000000000011111
100000000000000001100000000000000000000000000000000000000000000000000111
100000000000000001100000000000000000000000000000000000000000000000001
1000000000000000011000000000W00000000000000000000000000000000000000111
10000000000000001100000000000000000000000000000000000000000000000011
10000000000000000110000000000000000000000000000000000000000000000001
1111111111111111111111111111111111111111111111111111111111111111111

